AC	EY S IY
COLD	K OW L D
DOWN	D AW N
ENOUGH	IH N AH F
ENOUGH(2)	IY N AH F
FAN	F AE N
HEAT	HH IY T
HOT	HH AA T
HOT.	HH AA T
IS	IH Z
Iâ€™M	IH M
MUCH	M AH CH
MY	M AY
NOT	N AA T
ON	AA N
ON(2)	AO N
SEAT	S IY T
SPEED	S P IY D
STEERING	S T IH R IH NG
THE	DH AH
THE(2)	DH IY
TOO	T UW
TURN	T ER N
UP	AH P
WHEEL	W IY L
WHEEL(2)	HH W IY L
